3
s 13 13
s 19 13
p 10 10
20 17
2 2 2 2 2 2 2 2 2 2 2 2 2 2 2 2 2 2 2 2
0 2 0 0 0 0 0 0 0 0 0 2 0 0 0 0 0 0 0 1
0 2 0 1 0 0 0 0 0 0 0 2 0 0 0 0 0 0 0 1
0 2 0 0 0 0 0 0 0 0 0 2 0 1 0 0 0 0 0 1
0 2 0 0 0 0 0 0 0 0 0 2 0 1 0 0 0 0 0 1
0 2 1 0 0 0 0 0 0 0 0 2 0 1 0 0 0 0 0 1
0 2 0 0 0 0 0 0 0 0 0 2 0 1 0 0 0 0 0 1
0 2 0 0 0 0 0 0 0 0 0 2 0 0 0 0 0 0 0 1
0 2 0 1 0 0 0 0 0 0 0 2 0 0 0 0 0 0 0 1
0 2 0 0 0 0 0 0 0 0 0 2 0 0 0 0 0 0 0 1
0 2 0 0 0 0 0 0 0 0 0 2 0 0 0 0 0 0 0 1
0 2 1 0 0 0 0 0 0 0 0 2 1 0 0 0 0 0 0 3
0 0 0 0 0 0 0 0 0 0 0 0 0 0 0 0 0 0 0 3
0 0 0 0 0 0 0 0 0 1 0 0 0 0 0 0 0 0 0 3
0 0 0 0 0 1 1 1 2 2 0 0 0 0 0 1 1 1 1 1
1 0 0 0 1 2 2 2 2 2 0 1 0 0 0 0 0 2 2 2
2 1 1 1 2 2 2 2 2 2 2 1 2 2 2 2 2 2 2 2